0101 0000 0000 0000 0000 0000 0000 0000 0000 0000 0000 0000 0000 0000 0000 0101 0101 0101 0101 0101 0000 0000 0000 0000 0000 0000 0000 0101
0101 0000 0000 0000 0000 0000 0000 0000 0000 0000 0000 0101 0000 0000 0000 0000 0000 0000 0000 0101 0000 0000 0000 0000 0000 0000 0000 0101
0101 0000 0000 0000 0000 0000 0000 0000 0000 1002 0000 0101 0000 0000 0000 0000 0000 1001 0000 0000 0000 0000 0000 0000 0000 0000 0000 0101
0101 0000 0000 0000 0000 0000 0000 0000 0000 0000 0000 0101 0000 0000 0000 0000 0000 0000 0000 0000 0000 0000 0000 0000 0000 0000 0000 0101
0101 0000 0000 0000 0101 0000 0000 0000 0000 0000 0000 0000 0000 0000 0000 0000 0000 0000 0000 0000 0000 0101 0000 0000 1003 0000 0000 0101
0101 0000 0000 0101 0101 0000 0101 0101 0000 0000 0000 0000 0000 0000 0000 0000 0000 0000 0000 0000 0101 0101 0000 0000 0000 0000 0000 0101
0101 0101 0101 0101 0101 0101 0101 0101 0101 0101 0101 0101 0101 0101 0101 0000 0101 0000 0101 0000 0101 0101 0000 0101 0101 0101 0000 0101