0140 0140 0140 0140 0140 0140 0140 0140 0140 0140 0140 0140 0140 0140 0140 0140 0140 0140 0140 0140 0140 0140 0140 0140 0140 0140
0140 0000 0000 0000 0000 0000 0000 0000 0000 0000 0000 0000 0000 0000 0000 0000 0000 0000 0000 0000 0000 0000 0000 0000 0000 0140
0140 0000 0000 0000 0000 0000 0000 0000 0000 0000 0000 0000 0000 0000 0000 0000 0000 0000 0000 0000 0000 0000 0000 0000 0000 0140
0140 0000 0000 0000 0000 0000 0000 0000 0000 0000 0000 0000 0000 0000 0000 0000 0000 0000 0000 0000 0000 0000 0000 0000 0000 0140
0140 0000 0000 0000 0000 0000 0000 0000 0000 0000 0000 0000 0000 0000 0000 0000 0000 0000 0000 0000 0000 0000 0000 0000 0000 0140
0140 0000 0000 0000 0000 0000 0000 0000 0000 0000 0000 0000 0000 0000 0000 0000 0000 0000 0000 0000 0000 2000 0000 0000 0000 0140
0140 0000 0000 0000 0000 0000 0000 0000 0000 0000 0000 0000 0000 0000 0000 0000 0000 0000 0000 0000 0000 0000 0000 0000 0000 0140
0140 0000 0000 0000 0000 0000 0000 0000 0000 0000 0000 0000 0000 0000 0000 0000 0000 0000 0000 0000 0000 0000 0000 0000 0000 0140
0140 0000 0000 0000 0000 0000 0000 0000 0000 0000 0000 0000 0000 0000 0000 0000 0000 0000 0000 0000 0000 0000 0000 0000 0000 0140
0140 0000 0000 0000 0000 0000 0000 0000 0000 0000 0000 0000 0141 0141 0141 0141 0141 0141 0141 0141 0141 0141 0141 0141 0141 0140
0140 0000 0000 0000 0000 0000 0000 0000 0141 0141 0141 0141 0140 0140 0140 0140 0140 0140 0140 0140 0140 0140 0140 0140 0140 0140
0140 0141 0141 0141 0141 0141 0141 0141 0140 0140 0140 0140 0140 0140 0140 0140 0140 0140 0140 0140 0140 0140 0140 0140 0140 0140
0140 0140 0140 0140 0140 0140 0140 0140 0140 0140 0140 0140 0140 0140 0140 0140 0140 0140 0140 0140 0140 0140 0140 0140 0140 0140