0000 0000 0000 0000 0000 0000 0000 0000 0000 0000 0000 0000 0000 0000 0000 0000 0000 0000 0000 0000 0000 1001 0000 0000 0000 1001
0000 0000 0000 0000 0000 0000 0000 0000 0000 0000 0000 0000 0000 0000 0000 0000 0000 0000 0000 0000 0000 0000 0000 0000 0000 0000
0000 0000 0000 0000 0000 0000 0000 0000 0000 0000 0000 0000 0000 0000 0000 0000 0000 0000 0000 0000 0000 0000 0000 0000 0000 0000
0000 0000 0000 0000 0000 0000 0000 0000 0000 0000 0000 0000 0000 0000 0000 0000 0000 0000 0000 0000 0000 0000 0000 0000 0000 0000
0000 0000 0000 0000 0000 0000 1004 0000 0000 0000 0000 0000 0000 1002 0000 0000 0000 0000 0000 0000 0104 0000 0104 0000 0104 0000
0000 0000 0000 0000 0104 0104 0104 0104 0000 0000 0000 0000 0000 0000 0000 0104 0000 0000 0000 0104 0104 0104 0104 0104 0104 0104
0000 0000 0104 0104 0104 0104 0104 0104 0104 0104 0000 0000 0000 0000 0104 0104 0104 0104 0104 0104 0104 0104 0104 0104 0104 0104
0104 0104 0104 0104 0104 0104 0104 0104 0104 0104 0104 0104 0104 0104 0104 0104 0104 0104 0104 0104 0104 0104 0104 0104 0104 0104

0000 0000 0000 0000 0000 0000 0000 0000 0000 0000 0000 0000 0000 0000 0000 0000 0000 0000 0000 0000 0000 0000 0000 0000 0000 0000
0000 0000 0000 0000 0000 0000 0000 0000 0000 0000 0000 0000 0000 0104 0104 0104 0104 0000 0000 0000 0000 0000 0000 0000 0000 0000
0000 0000 0000 0000 0000 0000 0000 0104 0104 0104 0104 0104 0104 0104 0104 0104 0104 0104 0000 0000 0000 0000 0000 0000 0000 0000
0000 0000 0000 0000 0000 0000 0000 0000 0000 0000 0000 0000 0000 0000 0000 0000 0000 0000 0000 0000 0000 0000 0000 0000 0000 0000
0104 0104 0104 0104 0104 0000 0000 0000 0000 0000 0000 0000 0000 0000 0000 0000 0000 0000 0000 0000 0000 0000 0000 0000 0000 1002
0104 0104 0104 0104 0104 0104 0104 0000 0000 0000 0000 0000 0000 0000 0000 1003 0000 0000 0000 0000 0000 0000 0000 0000 0104 0000
0104 0104 0104 0104 0104 0104 0104 0104 0104 0000 0000 0000 0000 0000 0000 0000 0000 0000 0000 0000 0104 0000 0104 0000 0104 0000
0104 0104 0104 0104 0104 0104 0104 0104 0104 0104 0104 0104 0000 0104 0104 0104 0104 0104 0104 0104 0104 0000 0104 0000 0104 0000

0000 0000 0000 0000 0000 0000 0000 0000 0000 0000 0000 0000 0000 0000 0000 0000 0000 0000 0000 0000 0000 0000 0000 0000 0000 0000
0000 0000 0000 0000 0000 0000 0000 0000 0000 0000 0000 0000 0000 0000 0000 0000 0000 0000 0000 0000 0000 0000 0000 0000 0000 0000
0000 0000 0000 0000 0000 0000 0000 0000 0000 0000 0000 0000 0000 0000 0000 0000 0000 0000 0000 0000 0000 0000 0000 0000 0000 0000
0000 0000 0000 0000 0000 0000 0000 0000 0000 0000 0000 0000 0000 0000 0000 0000 0000 0000 0000 0000 0000 0000 0000 0000 0000 0000
0000 1002 0000 1002 0000 0000 0000 0000 0000 0000 0000 0000 0000 0000 0000 0000 0000 0000 0000 0000 0000 0000 0000 0000 0000 0000
0104 0000 0104 0000 0104 0104 0000 0000 0000 0000 0000 0000 0000 0000 0000 1003 0000 0000 0000 0000 0000 0000 0000 0000 0000 0000
0104 0000 0104 0000 0104 0104 0104 0104 0000 0000 0000 0000 0000 0000 0000 0000 0000 0104 0104 0104 0104 0104 0104 0104 0104 0104
0104 0000 0104 0000 0104 0104 0104 0104 0104 0104 0104 0104 0000 0000 0104 0104 0104 0104 0104 0104 0104 0104 0104 0104 0104 0104