0000 0000 0000 0000 0000 0000 0000 0000 0000 0000 0000 0000 0000 0000 0000 0000 0000 0000 0000 0000 0000 0000 0000 0000 0000 0000
0000 0000 0000 0000 0000 0000 0000 0000 0000 0000 0000 0000 0000 0000 0000 0000 0000 0000 0000 0000 0000 0000 0000 0000 0000 0000
0000 0000 0000 0000 0000 0000 0000 0000 0000 0000 0000 0000 0000 0000 0000 0000 0000 0000 0000 0000 0000 0000 0000 0000 0000 0000
0000 0000 0000 0000 0000 0000 0000 0000 0000 0000 0000 0000 0000 0000 0000 0000 0000 0000 0000 0000 0000 0000 0000 0000 0000 0000
0000 0000 0000 0000 0000 0000 0000 0000 0000 0000 0000 0000 0000 0000 0000 0000 0000 0000 0000 0000 0000 0000 0000 0000 0000 0000
0000 0000 0000 0000 0000 0000 0000 0000 0000 0000 0000 0000 0000 0000 0000 0000 0000 0000 0000 0000 0000 0000 0000 0000 0000 0000
0000 0000 0000 0000 0000 0000 0000 0000 0000 0000 0000 0000 0000 0000 0000 0000 0000 0000 0000 0000 0000 0000 0000 0000 0000 0000
0000 0000 0000 0000 0000 0000 0000 0000 0000 0000 0000 0000 0000 0000 0000 0000 0000 0000 0000 0000 0000 0000 0000 0000 0000 0000
0000 0000 0000 0000 0000 0000 0000 0000 0000 0000 0000 0000 0000 0000 0000 0000 0000 0000 0000 0000 0000 0000 0000 0000 0000 0000
0000 0000 0000 0000 0000 0000 0000 0000 0000 0000 0000 0000 0000 0000 0000 0000 0000 0000 0000 0000 0000 0000 0000 0000 0000 0000
0000 0000 0000 0000 0000 0000 0000 0000 0000 0000 0000 0000 0000 0000 0000 0000 0000 0000 0000 0000 0000 0000 0000 0107 0108 0105
0000 0000 0000 0000 0000 0000 0000 0000 0000 0000 0000 0000 0000 0000 0000 0137 0137 0137 0000 0000 0000 0000 0000 0115 0116 0104
0000 0000 0000 0000 0000 0000 0000 0000 0000 0000 0000 0000 0000 0000 0000 0000 0000 0000 0000 0000 0000 0000 0000 0115 0116 0104
0000 0000 0000 0000 0000 0000 0000 0000 0000 0000 0000 0000 0000 0000 0000 0000 0000 0000 0000 0000 0000 0000 0000 0115 0116 0104
0000 0000 0000 0000 0000 0000 0000 0000 0000 0000 0000 0000 0000 0000 0000 0000 0000 0000 0000 0000 0000 0000 0000 0115 0116 0104
0000 0000 0000 0000 0000 0000 0000 0000 0000 0000 0136 0136 0000 0000 0000 0000 0000 0000 0000 0000 0000 0000 0000 0115 0116 0104
0000 0000 0000 0000 0000 0000 0000 0000 0000 0136 0136 0136 0000 0000 0000 0000 0000 0000 0000 0000 0000 0000 0000 0115 0116 0104
0105 0105 0105 0105 0105 0105 0105 0105 0105 0105 0105 0105 0105 0105 0105 0105 0105 0105 0105 0105 0105 0105 0105 0123 0124 0104
0104 0104 0104 0104 0104 0104 0104 0104 0104 0104 0104 0104 0104 0104 0104 0104 0104 0104 0104 0104 0104 0104 0104 0104 0104 0104

0000 0000 0000 0000 0000 0000 0000 0000 0000 0000 0000 0000 0000 0000 0000 0000 0000 0000 0000 0000 0000 0000 0000 0000 0000 0000
0000 0000 0000 0000 0000 0000 0000 0000 0000 0000 0000 0000 0000 0000 0000 0000 0000 0000 0000 0000 0000 0000 0000 0000 0000 0000
0000 0000 0000 0000 0000 0000 0000 0000 0000 0000 0000 0000 0000 0000 0000 0000 0000 0000 0000 0000 0000 0000 0000 0000 0000 0000
0000 0000 0000 0000 0000 0000 0000 0000 0000 0000 0000 0000 0000 0000 0000 0000 0000 0000 0000 0000 0000 0000 0000 0000 0000 0000
0000 0000 0000 0000 0000 0000 0000 0000 0000 0000 0000 0000 0000 0000 0000 0000 0000 0000 0000 0000 0000 0000 0000 0000 0000 0000
0000 0000 0000 0000 0000 0000 0000 0000 0000 0000 0000 0000 0000 0000 0000 0000 0000 0000 0000 0000 0000 0000 0000 0000 0000 0000
0000 0000 0000 0000 0000 0000 0000 0000 0000 0000 0000 0000 0000 0000 0000 0000 0000 0000 0000 0000 0000 0000 0000 0000 0000 0000
0000 0000 0000 0000 0000 0000 0000 0000 0000 0000 0000 0000 0000 0000 0000 0000 0000 0000 0000 0000 0000 0000 0000 0000 0000 0000
0000 0000 0000 0000 0000 0000 0000 0000 0000 0000 0000 0000 0000 0000 0000 0000 0000 0000 0000 0000 0000 0000 0000 0000 0000 0000
0000 0000 0000 0000 0000 0000 0000 0000 0000 0000 0000 0000 0000 0000 0000 0000 0000 0000 0000 0000 0000 0000 0000 0000 0000 0000
0000 0000 0000 0000 0000 0000 0000 0000 0000 0000 0000 0000 0000 0000 0000 0000 0000 0000 0000 0000 0000 0000 0000 0000 0000 0000
0105 0105 0105 0000 0000 0000 0000 0000 0000 0000 0000 0000 0000 0000 0000 0000 0000 0000 0000 0000 0000 0000 0000 0000 0000 0000
0104 0104 0104 0105 0105 0000 0000 0000 0000 0000 0000 0000 0000 0000 0000 0000 0000 0000 0000 0000 0000 0000 0000 0000 0000 0000
0104 0104 0104 0104 0104 0105 0105 0105 0000 0000 1004 0000 0000 0000 0000 0000 0000 0000 0000 0000 0000 0000 0000 0000 0000 0000
0104 0104 0104 0104 0104 0104 0104 0104 0105 0105 0105 0105 0105 0105 0000 0000 0000 0000 0000 0000 0000 0000 0000 0000 0000 0000
0104 0104 0104 0104 0104 0104 0104 0104 0104 0104 0104 0104 0104 0104 0105 0105 0105 0000 0000 0000 0000 0000 0000 0000 0000 0000
0104 0104 0104 0104 0104 0104 0104 0104 0104 0104 0104 0104 0104 0104 0104 0104 0104 0105 0105 0105 0105 0000 0000 0000 0000 0000
0104 0104 0104 0104 0104 0104 0104 0104 0104 0104 0104 0104 0104 0104 0104 0104 0104 0104 0104 0104 0104 0105 0105 0105 0105 0105
0104 0104 0104 0104 0104 0104 0104 0104 0104 0104 0104 0104 0104 0104 0104 0104 0104 0104 0104 0104 0104 0104 0104 0104 0104 0104

0000 0000 0000 0000 0000 0000 0000 0000 0000 0000 0000 0000 0000 0000 0000 0000 0000 0000 0000 0000 0000 0000 0000 0000 0000 0000
0000 0000 0000 0000 0000 0000 0000 0000 0000 0000 0000 0000 0000 0000 0000 0000 0000 0000 0000 0000 0000 0000 0000 0000 0000 0000
0000 0000 0000 0000 0000 0000 0000 0000 0000 0000 0000 0000 0000 0000 0000 0000 0000 0000 0000 0000 0000 0000 0000 0000 0000 0000
0000 0000 0000 0000 0000 0000 0000 0000 0000 0000 0000 0000 0000 0000 0000 0000 0000 0000 0000 0000 0000 0000 0000 0000 0000 0000
0000 0000 0000 0000 0000 0000 0000 0000 0000 0000 0000 0000 0000 0000 0000 0000 0000 0000 0000 0000 0000 0000 0000 0000 0000 0000
0000 0000 0000 0000 0000 0000 0000 0000 0000 0000 0000 0000 0000 0000 0000 0000 0000 0000 0000 0000 0000 0000 0000 0000 0000 0000
0000 0000 0000 0000 0000 0000 0000 0000 0000 0000 0000 0000 0000 0000 0000 0000 0000 0000 0000 0000 0000 0000 0000 0000 0000 0000
0000 0000 0000 0000 0000 0000 0000 0000 0000 0000 0000 0000 0000 0000 0000 0000 0000 0000 0000 0000 0000 0000 0000 0000 0000 0000
0000 0000 0000 0000 0000 0000 0000 0000 0000 0000 0000 0000 1001 0000 0000 0000 0000 0000 0000 0000 0000 0000 0000 0000 0000 0000
0000 0000 0000 0000 0000 0000 0000 0000 0000 0000 0000 0000 0000 0000 0000 0000 0000 0000 0000 0000 0000 0000 0000 0000 0000 0000
0000 0000 0000 0000 0000 0000 0000 0000 0000 0000 0000 0000 0000 0000 0000 0000 0000 0000 0000 0000 0000 0000 0000 0000 0000 0000
0000 0000 0000 0000 0000 0000 0000 0000 0000 0000 0000 0000 0000 0000 0000 0000 0000 0000 0000 0000 0000 0000 0000 0000 0000 0000
0000 0000 0000 0000 0000 0000 0000 0000 0000 0000 0000 0000 0000 0000 0000 0000 0000 0000 0000 0000 0000 0000 0000 0000 0000 0000
0000 0000 0000 0000 0000 0000 0000 0000 0000 0000 0000 0000 0000 0000 0000 0000 0000 0000 0000 0000 0000 0000 0000 0000 0000 0000
0000 0000 0000 0000 0000 0000 0000 0000 0000 0000 0000 0137 0137 0137 0137 0000 0000 0000 0000 0000 0000 0000 0000 0000 0000 0000
0000 0000 0000 0000 0000 0000 0000 0000 0000 0000 0000 0000 0000 0000 0000 0000 0000 0000 0000 0000 0000 0000 0000 0000 0000 0000
0000 0000 0000 0000 0000 0000 0000 0000 0000 0000 0000 0000 0000 0000 0000 0000 0000 0000 0000 0000 0000 0000 0000 0000 0000 0000
0105 0105 0105 0105 0105 0105 0105 0105 0000 0000 0000 0000 0000 0000 0000 0000 0000 0000 0105 0105 0105 0105 0105 0105 0105 0105
0104 0104 0104 0104 0104 0104 0104 0104 0000 0000 0000 0000 0000 0000 0000 0000 0000 0000 0104 0104 0104 0104 0104 0104 0104 0104

0000 0000 0000 0000 0000 0000 0000 0000 0000 0000 0000 0000 0000 0000 0000 0000 0000 0000 0000 0000 0000 0000 0000 0000 0000 0000
0000 0000 0000 0000 0000 0000 0000 0000 0000 0000 0000 0000 0000 0000 0000 0000 0000 0000 0000 0000 0000 0000 0000 0000 0000 0000
0000 0000 0000 0000 0000 0000 0000 0000 0000 0000 0000 0000 0000 0000 0000 0000 0000 0000 0000 0000 0000 0000 0000 0000 0000 0000
0000 0000 0000 0000 0000 0000 0000 0000 0000 0000 0000 0000 0000 0000 0000 0000 0000 0000 0000 0000 0000 0000 0000 0000 0000 0000
0000 0000 0000 0000 0000 0000 0000 0000 0000 0000 0000 0000 0000 0000 0000 0000 0000 0000 0000 0000 0000 0000 0000 0000 0000 0000
0000 0000 0000 0000 0000 0000 0000 0000 0000 0000 0000 0000 0000 0000 0000 0000 0000 0000 0000 0000 0000 0000 0000 0000 0000 0000
0000 0000 0000 0000 0000 0000 0000 0000 0000 0000 0000 0000 0000 0000 0000 0000 0000 0000 0000 0000 0000 0000 0000 0000 0000 0000
0000 0000 0000 0000 0000 0000 0000 0000 0000 0000 0000 0000 0000 0000 0000 0000 0000 0000 0000 0000 0000 0000 0000 0000 0000 0000
0000 0000 0000 0000 0000 0000 0000 0000 0000 0000 0000 0000 0000 0000 0000 0000 0000 0000 0000 0000 0000 0000 0000 0000 0000 0000
0000 0000 0000 0000 0000 0000 0000 0000 0000 0000 0000 0000 0000 0000 0000 0000 0000 0000 0000 0137 0000 0000 0000 0000 0000 0000
0000 0000 0000 0000 0000 0000 0000 0000 0000 0000 0000 0000 0000 0000 0000 0000 0000 0000 0000 0000 0000 0000 0000 0000 0000 0000
0000 0000 0000 0000 0000 0000 0000 0000 0000 0000 0000 0000 0137 0137 0000 0000 0000 0000 0000 0000 0000 0000 0000 0000 0000 0000
0000 0000 0000 0000 0000 0000 0000 0000 0000 0000 0000 0000 0000 0000 0000 0000 0000 0000 0000 0000 0000 0000 0000 0000 0000 0000
0000 0000 0000 0000 0000 0000 0000 0000 0000 0000 0000 0000 0000 0000 0000 0000 0000 0000 0000 0000 0000 0000 0000 0000 0000 0000
0000 0000 0000 0000 0000 0137 0137 0137 0000 0000 0000 0000 0000 0000 0000 0000 0000 0000 0000 0000 0000 0000 0000 0000 0000 0000
0000 0000 0000 0000 0000 0000 0000 0000 0000 0000 0000 0000 0000 0000 0000 0000 0000 0000 0000 0000 0000 0000 0000 0000 0000 0105
0000 0000 0000 0000 0000 0000 0000 0136 0000 0000 0000 0000 0000 1004 0000 0000 0000 0000 0000 0000 0000 0000 0000 0000 0105 0104
0105 0105 0105 0105 0105 0105 0105 0105 0105 0105 0105 0105 0105 0105 0105 0105 0105 0105 0105 0105 0105 0105 0105 0105 0104 0104
0104 0104 0104 0104 0104 0104 0104 0104 0104 0104 0104 0104 0104 0104 0104 0104 0104 0104 0104 0104 0104 0104 0104 0104 0104 0104

0000 0000 0000 0000 0000 0000 0000 0000 0000 0000 0000 0000 0000 0000 0000 0000 0000 0000 0000 0000 0000 0000 0000 0000 0000 0000
0000 0000 0000 0000 0000 0000 0000 0000 0000 0000 0000 0000 0000 0000 0000 0000 0000 0000 0000 0000 0000 0000 0000 0000 0000 0000
0000 0000 0000 0000 0000 0000 0000 0000 0000 0000 0000 0000 0000 0000 0000 0000 0000 0000 0000 0000 0000 0000 0000 0000 0000 0000
0000 0000 0000 0000 0000 0000 0000 0000 0000 0000 0000 0000 0000 0000 0000 0000 0000 0000 0000 0000 0000 0000 0000 0000 0000 0000
0000 0000 0000 0000 0000 0000 0000 0000 0000 0000 0000 0000 0000 0000 0000 0000 0000 0000 0000 0000 0000 0000 0000 0000 0000 0000
0000 0000 0000 0000 0000 0000 0000 0000 0000 0000 0000 0000 0000 0000 0000 0000 0000 0000 0000 0000 0000 0000 0000 0000 0000 0000
0000 0000 0000 0000 0000 0000 0000 0000 0000 0000 0000 0000 0000 0000 0000 0000 0000 0000 0000 0000 0000 0000 0000 0000 0000 0000
0000 0000 0000 0000 0000 0000 0000 0000 0000 0000 0000 0000 0000 0000 0000 0000 0000 0000 0000 0000 0000 0000 0000 0000 0000 0000
0107 0108 0109 0109 0000 0000 0000 0000 0000 0000 0000 0000 0000 0000 0000 0000 0000 0000 0000 0000 0000 0000 0000 0000 0000 0000
0115 0116 0109 0000 0000 0000 0000 0000 0000 0000 0000 0000 0000 0000 0000 0000 0000 0000 0000 0000 0000 0000 0000 0000 0000 0000
0115 0116 0000 0000 0000 0000 0000 0000 0000 0000 0000 0000 0000 0000 0000 0000 0000 0000 0000 0000 0000 0000 0000 0000 0000 0000
0115 0116 0000 0000 0000 0000 0000 0000 0000 0000 0000 0000 0000 0000 0000 0000 0000 0000 0000 0000 0000 0000 0000 0000 0000 0000
0115 0116 0000 0000 0000 0000 0000 0000 0000 0000 0000 0110 0000 0000 0000 0000 0000 0000 0000 0000 0000 0000 0000 0000 0000 0000
0115 0116 0000 0000 0000 0000 0000 0000 0000 0000 0110 0116 0000 0000 0000 0000 0000 0000 0000 0000 0000 0000 0000 0000 0000 0000
0115 0116 0000 0000 0000 0000 0000 0000 0000 0000 0115 0116 0000 0000 0000 0000 0000 0000 0000 0000 0000 0000 0000 0000 0000 0000
0115 0116 0105 0000 0000 0000 0000 0000 0000 0105 0115 0116 0000 0000 0000 0000 0000 0000 0000 0000 0000 0000 0000 0000 0000 0000
0115 0116 0104 0105 0122 0109 0000 0000 0105 0104 0115 0116 0105 0000 0000 0000 0000 0000 0000 0000 0000 0000 0000 0000 0000 0000
0123 0124 0104 0104 0104 0104 0105 0105 0104 0104 0123 0124 0104 0105 0105 0105 0105 0122 0109 0000 0000 0000 0000 0000 0000 0000
0104 0104 0105 0104 0104 0104 0104 0104 0104 0104 0104 0104 0104 0104 0104 0104 0104 0104 0104 0105 0105 0105 0105 0105 0105 0105

0000 0000 0000 0000 0000 0000 0000 0000 0000 0000 0000 0017 0011 0011 0011 0011 0011 0011 0011 0011 0011 0011 0011 0011 0011 0011
0000 0000 0000 0000 0000 0000 0000 0000 0000 0000 0000 0017 0011 0011 0018 0019 0011 0011 0011 0011 0018 0019 0011 0011 0011 0011
0000 0000 0000 0000 0000 0000 0000 0000 0000 0000 0000 0017 0011 0011 0026 0027 0011 0011 0011 0011 0026 0027 0011 0011 0011 0011
0000 0000 0000 0000 0000 0000 0000 0000 0000 0000 0000 0017 0011 0011 0011 0011 0011 0011 0011 0011 0011 0011 0011 0011 0011 0011
0000 0000 0000 0000 0000 0000 0000 0000 0000 0000 0000 0017 0011 0011 0011 0011 0011 0011 0011 0011 0011 0011 0011 0011 0011 0011
0000 0000 0000 0000 0000 0000 0000 0000 0000 0000 0000 0017 0011 0011 0011 0011 0011 0011 0011 0011 0011 0011 0011 0011 0011 0011
0000 0000 0000 0000 0000 0000 0000 0000 0000 0000 0000 0017 0011 0011 0011 0011 0011 0011 0011 0011 0011 0011 0011 0011 0011 0011
0000 0000 0000 0000 0000 0000 0000 0000 0000 0000 0000 0017 0011 0011 0018 0019 0011 0011 0011 0011 0018 0019 0011 0011 0011 0011
0000 0000 0000 0000 0000 0000 0000 0000 0000 0000 0000 0017 0011 0011 0026 0027 0011 0011 0011 0011 0026 0027 0011 0011 0011 0011
0000 0000 0000 0000 0000 0000 0000 0000 0000 0000 0000 0017 0011 0011 0011 0011 0011 0011 0011 0011 0011 0011 0011 0011 0011 0011
0000 0000 0000 0000 0000 0000 0000 0000 0000 0000 0000 0017 0011 0011 0011 0011 0011 0011 0011 0011 0011 0011 0011 0011 0011 0011
0000 0000 0000 0000 0000 0000 0000 0000 0000 0000 0000 0017 0011 0011 0011 0011 0011 0011 0011 0011 0011 0011 0011 0011 0011 0011
0000 0000 0000 0000 0000 0000 0000 0000 0000 0000 0000 0017 0011 0011 0011 0011 0011 0011 0011 0011 0011 0011 0011 0011 0011 0011
0000 0000 0000 0000 0000 0000 0000 0000 0000 0000 0000 0017 0011 0011 0011 0011 0011 0011 0011 0011 0011 0011 0011 2000 0011 0011
0000 0000 0000 0000 0000 0000 0000 0000 0000 0000 0000 0017 0011 0011 0011 0011 0011 0011 0011 0011 0011 0011 0011 0011 0011 0011
0000 0000 0000 0000 0000 0000 0000 0000 0000 0000 0000 0017 0011 0011 0011 0011 0011 0011 0011 0011 0011 0011 0011 0011 0011 0011
0000 0000 0000 0000 0000 0000 0000 0000 0000 0000 0000 0017 0011 0011 0011 0011 0011 0011 0011 0011 0011 0011 0011 0011 0011 0011
0000 0000 0000 0000 0000 0000 0000 0000 0000 0000 0109 0109 0109 0109 0109 0109 0109 0109 0109 0109 0109 0109 0109 0109 0109 0109
0105 0105 0105 0105 0105 0105 0105 0105 0105 0105 0104 0104 0104 0104 0104 0104 0104 0104 0104 0104 0104 0104 0104 0104 0104 0104

0011 0011 0011 0011 0011 0011 0011 0011 0011 0011 0025 0000 0000 0000 0000 0000 0000 0000 0000 0000 0000 0000 0000 0000 0000 0000
0018 0019 0011 0011 0011 0011 0018 0019 0011 0011 0025 0000 0000 0000 0000 0000 0000 0000 0000 0000 0000 0000 0000 0000 0000 0000
0026 0027 0011 0011 0011 0011 0026 0027 0011 0011 0025 0000 0000 0000 0000 0000 0000 0000 0000 0000 0000 0000 0000 0000 0000 0000
0011 0011 0011 0011 0011 0011 0011 0011 0011 0011 0025 0000 0000 0000 0000 0000 0000 0000 0000 0000 0000 0000 0000 0000 0000 0000
0011 0011 0011 0011 0011 0011 0011 0011 0011 0011 0025 0000 0000 0000 0000 0000 0000 0000 0000 0000 0000 0000 0000 0000 0000 0000
0011 0011 0011 0011 0011 0011 0011 0011 0011 0011 0025 0000 0000 0000 0000 0000 0000 0000 0000 0000 0000 0000 0000 0000 0000 0000
0011 0011 0011 0011 0011 0011 0011 0011 0011 0011 0025 0000 0000 0000 0000 0000 0000 0000 0000 0000 0000 0000 0000 0000 0000 0000
0018 0019 0011 0011 0011 0011 0018 0019 0011 0011 0025 0000 0000 0000 0000 0000 0000 0000 0000 0000 0000 0000 0000 0000 0000 0000
0026 0027 0011 0011 0011 0011 0026 0027 0011 0011 0025 0000 0000 0000 0000 0000 0000 0000 0000 0000 0000 0000 0000 0000 0000 0000
0011 0011 0011 0011 0011 0011 0011 0011 0011 0011 0025 0000 0000 0000 0000 0000 0000 0000 0000 0000 0000 0000 0000 0000 0000 0000
0011 0011 0011 0011 0011 0011 0011 0011 0011 0011 0025 0000 0000 0000 0000 0000 0000 0000 0000 0000 0000 0000 0000 0000 0000 0000
0011 0011 0011 0011 0011 0011 0011 0011 0011 0011 0025 0000 0000 0000 0000 0000 0000 0000 0000 0000 0000 0000 0000 0000 0000 0000
0011 0011 0011 0011 0011 0011 0011 0011 0011 0011 0025 0000 0000 0000 0000 0000 0000 0000 0000 0000 0000 0000 0000 0000 0000 0000
0011 0011 0011 0011 0011 0011 0011 0011 0011 0011 0025 0000 0000 0000 0000 0000 0000 0000 0000 0000 0000 0000 0000 0000 0000 0000
0011 0011 0011 0011 0011 0011 0011 0011 0011 0011 0025 0000 0000 0000 0000 0000 0000 0000 0000 0000 0000 0000 0000 0000 0000 0000
0011 0011 0011 0011 0011 0011 0011 0011 0011 0011 0025 0000 0000 0000 0000 0000 0000 0000 0000 0000 0000 0000 0000 0000 0000 0000
0011 0011 0011 0011 0011 0011 0011 0011 0011 0011 0025 0000 0000 0000 0000 0000 0000 0000 0000 0000 0000 0000 0000 0000 0000 0000
0109 0109 0109 0109 0109 0109 0109 0109 0109 0109 0109 0109 0000 0000 0000 0000 0000 0000 0000 0000 0000 0000 0000 0000 0000 0000
0104 0104 0104 0104 0104 0104 0104 0104 0104 0104 0104 0105 0105 0105 0105 0105 0105 0105 0105 0105 0105 0105 0105 0105 0105 0105