0000 0000 0000 0000 0000 0000 0000 0000 0000 0000 0000 0000 0000 0000 0000 0000 0000 0000 0000 0000 0000 0000 0000 0000 0000 0000
0000 0000 0000 0000 0000 0000 0000 0000 0000 0000 0000 0000 0000 0000 0000 0000 0000 0000 0000 0000 0000 0000 0000 0000 0000 0000
0000 0000 0000 0000 0000 0000 0000 0000 0000 0000 0000 0000 0000 0000 0000 0000 0000 0000 0000 0000 0000 0000 0000 0000 0000 0000
0000 0000 0000 0000 0000 0000 0000 0000 0000 0000 0000 0114 0114 0114 0114 0114 0114 0114 0114 0114 0114 0114 0114 0114 0000 0000
0000 0000 0000 0000 0000 0000 0000 0000 0000 0000 0000 0113 0113 0113 0113 0113 0113 0113 0113 0113 0113 0113 0113 0113 0000 0000
0000 0000 0000 0000 0000 0000 0000 0000 0000 0000 0000 0112 0112 0112 0112 0112 0112 0112 0112 0112 0112 0112 0112 0112 0000 0000
0000 0000 0000 0000 0000 0000 0000 0114 0114 0114 0114 0117 0111 0111 0111 0111 0111 0111 0111 0111 0111 0111 0111 0125 0000 0000
0000 0000 0000 0000 0000 0000 0000 0113 0113 0113 0113 0117 0111 0111 0118 0119 0111 0111 0111 0118 0119 0111 0111 0125 0000 0000
0000 0000 0000 0000 0000 0000 0000 0112 0112 0112 0112 0117 0111 0111 0126 0127 0111 0111 0111 0126 0127 0111 0111 0125 0000 0000
0000 0000 0000 0000 0000 0000 0000 0117 0111 0111 0111 0117 0111 0111 0111 0111 0111 0111 0111 0111 0111 0111 0111 0125 0000 0000
0000 0000 0000 0000 0000 0000 0000 0109 0109 0109 0109 0109 0109 0109 0109 0109 0109 0109 0109 0109 0109 0109 0109 0109 0000 0000
0105 0105 0105 0105 0122 0109 0109 0109 0109 0109 0109 0109 0109 0109 0109 0109 0109 0109 0109 0109 0109 0109 0109 0109 0109 0105
0104 0104 0106 0104 0104 0104 0104 0104 0104 0104 0104 0104 0104 0104 0104 0104 0104 0104 0104 0104 0104 0104 0121 0104 0104 0104

0000 0000 0000 0000 0000 0000 0000 0000 0000 0000 0000 0000 0000 0000 0000 0000 0000 0000 0000 0000 0000 0000 0000 0000 0000 0000
0000 0000 0000 0000 0000 0000 0000 0000 0000 0000 0000 0000 0000 0000 0000 0000 0000 0000 0000 0000 0000 0000 0000 0000 0000 0000
0000 0000 0000 0000 0000 0000 0000 0000 0000 0000 0000 0000 0000 0000 0000 0000 0000 0000 0000 0000 0000 0000 0000 0000 0000 0000
0000 0000 0000 0000 0000 0000 0000 0000 0000 0000 0000 0000 0000 0000 0000 0000 0000 0000 0000 0000 0000 0000 0000 0000 0000 0000
0000 0000 0000 0000 0000 0000 0000 0000 0000 0000 0000 0000 0000 0000 0000 0000 0000 0000 0000 0000 0000 0000 0000 0000 0000 0000
0000 0000 0000 0000 0000 0000 0000 0000 0000 0000 0000 0000 0000 0000 0000 0000 0000 0000 0000 0000 0000 0000 0000 0000 0137 0137
0000 0000 0000 0000 0000 0000 0000 0000 0000 0000 0000 0000 0000 0000 0000 0000 0000 0000 0000 0000 0000 0000 0000 0000 0000 0000
0000 0000 0000 0000 0000 0000 0000 0000 0000 0000 0000 0000 0000 0000 0000 0000 0000 0000 0000 0000 0000 0000 0000 0000 0000 0000
0000 0000 0000 0000 0000 0000 0000 0000 0000 0000 0000 0000 0105 0105 0105 0105 0105 0105 0105 0105 0000 0000 0000 0000 0000 0000
0000 0000 0000 0000 0000 0000 0000 0000 0000 0105 0105 0105 0104 0104 0104 0104 0104 0104 0104 0104 0029 0029 0029 0029 0029 0029
0000 0000 0000 0000 0000 0000 0105 0105 0105 0104 0104 0104 0104 0104 0104 0104 0104 0104 0104 0104 0128 0128 0128 0128 0128 0128
0105 0105 0105 0105 0105 0105 0104 0104 0104 0104 0104 0104 0104 0104 0104 0104 0104 0104 0104 0104 0128 0128 0128 0128 0128 0128
0104 0104 0106 0104 0104 0104 0104 0104 0104 0104 0104 0104 0104 0104 0104 0104 0104 0104 0104 0104 0104 0104 0121 0104 0104 0104

0000 0000 0000 0000 0000 0000 0000 0000 0000 0000 0000 0000 0000 0000 0000 0000 0000 0000 0000 0000 0000 0000 0000 0000 0000 0000
0000 0000 0000 0000 0000 0000 0000 0000 0000 0000 0000 0000 0000 0000 0000 0000 0000 0000 0000 0000 0000 0000 0000 0000 0000 0000
0000 0000 0000 0000 0000 0000 0000 0000 0000 0000 0000 0000 0000 0000 0000 0000 0000 0000 0000 0000 0000 0000 0000 0000 0000 0000
0000 0000 0000 0000 0000 0000 0000 0000 0000 0000 0000 0000 0000 0000 0000 0000 0000 0000 0000 0000 0000 0000 0000 0000 0000 0000
0000 0000 0000 0000 0000 0000 0000 0000 0000 0000 0000 0000 0000 0000 0000 0000 0000 0000 0000 0000 0000 0000 0000 0000 0000 0000
0105 0105 0000 0000 0000 0000 0000 0000 0000 0000 0000 0000 0000 0000 0000 0000 0000 0000 0000 0000 0000 0000 0000 0000 0000 0000
0000 0000 0000 0000 0000 0000 0000 0000 0000 0000 0105 0105 0105 0105 0109 0000 0000 0000 0000 0000 0000 0000 0000 0000 0000 0000
0000 0000 0000 0000 0000 0000 0000 0105 0105 0105 0104 0104 0104 0104 0109 0110 0107 0108 0000 0000 0000 0000 0000 0000 0000 0000
0000 0000 0000 0000 0000 0000 0105 0104 0104 0104 0104 0104 0104 0104 0122 0109 0115 0116 0000 0000 0000 0000 0000 0000 0000 0000
0029 0029 0029 0029 0029 0029 0104 0104 0104 0104 0104 0104 0104 0104 0104 0122 0115 0116 0109 0000 0000 0000 0000 0000 0000 0000
0128 0128 0128 0128 0128 0128 0104 0121 0104 0104 0104 0104 0104 0104 0104 0104 0123 0124 0109 0109 0105 0105 0105 0105 0105 0105
0128 0128 0128 0128 0128 0128 0104 0104 0104 0104 0104 0104 0104 0104 0104 0104 0104 0104 0104 0104 0104 0104 0104 0104 0104 0104
0104 0104 0106 0104 0104 0104 0104 0104 0104 0104 0104 0104 0104 0104 0104 0104 0104 0104 0104 0104 0104 0104 0104 0104 0104 0104