0000 0000 0000 0000 0000 0000 0000 0000 0000 0000 0000 0000 0000 0000 0000 0000 0000 0000 0000 0000 0000 0000 0000 0000 0000 0000 0000 0000 0000 0000 0000 0000
0000 0000 0000 0000 0000 0000 0000 0000 0000 0000 0000 0000 0000 0000 0000 0000 0000 0000 0000 0000 0000 0000 0000 0000 0000 0000 0000 0000 0000 0000 0000 0000
0000 0000 0000 0000 0000 0000 0000 0000 0000 0000 0000 0000 0000 0000 0000 0000 0000 0000 0000 0000 0000 0000 0000 0000 0000 0000 0000 0000 0000 0000 0000 0000
0000 0000 0000 0000 0000 0000 0000 0000 0000 0000 0000 0000 0000 0000 0000 0000 0000 0000 0000 0000 0000 0000 0000 0000 0000 0000 0000 0000 0000 0000 0000 0000
0000 0000 0000 0000 0000 0000 0000 0000 0000 0000 0000 0000 0114 0114 0114 0114 0114 0114 0000 0000 0000 0000 0000 0000 0000 0000 0000 0000 0000 0000 0000 0000
0000 0000 0000 0000 0000 0000 0000 0000 0000 0000 0000 0114 0112 0112 0112 0112 0112 0112 0114 0000 0000 0000 0000 0000 0000 0000 0000 0000 0000 0000 0000 0000
0000 0000 0000 0000 0000 0000 0000 0000 0000 0000 0000 0112 0011 0011 0011 0011 0011 0011 0112 0000 0000 0000 0000 0000 0000 0000 0000 0000 0000 0000 0000 0000
0000 0000 0000 0000 0000 0000 0000 0000 0000 0000 0000 0017 0011 2001 0011 0011 0011 0011 0025 0000 0000 0000 0000 0000 0000 0000 0000 0000 0000 0000 0000 0000
0000 0000 0000 0000 0000 0000 0000 0000 0000 0000 0000 0017 0011 0011 0011 0011 0011 0011 0025 0000 0000 0000 0000 0000 0000 0000 0000 0000 0000 0000 0000 0000
0000 0000 0000 0000 0000 0000 0000 0000 0000 0000 0000 0017 0011 0011 0011 0011 0011 0011 0025 0000 0000 0000 0000 0000 0000 0000 0000 0000 0000 0000 0000 0000
0000 0000 0000 0000 0000 0000 0000 0000 0000 0000 0000 0017 0011 0011 0011 0011 0011 0011 0025 0000 0000 0000 0000 0000 0000 0000 0000 0000 0000 0000 0000 0000
0000 0000 0000 0000 0000 0000 0000 0000 0000 0000 0109 0109 0109 0109 0109 0109 0109 0109 0109 0109 0109 0000 0000 0000 0000 0000 0000 0000 0000 0000 0000 0000
0000 0000 0000 0000 0000 0000 0000 0109 0109 0109 0109 0109 0109 0109 0109 0109 0109 0109 0109 0109 0109 0109 0109 0109 0109 0000 0000 0000 0000 0000 0000 0000
0000 0000 0000 0000 0000 0017 0011 0011 0011 0011 0011 0011 0011 0011 0011 0011 0011 0011 0011 0011 0011 0011 0011 0011 0011 0011 0025 0000 0000 0000 0109 0000
0000 0000 0000 0000 0000 0017 0011 0011 0011 0011 0011 0011 0011 0011 0011 0011 0011 0011 0011 0011 0011 0011 0011 0011 0011 0011 0025 0000 0000 0000 0000 0000
0000 0000 0000 0000 0000 0017 0011 0011 0011 0011 0011 0011 0011 0011 0011 0011 0011 0011 0011 0011 0011 0011 0011 0011 0011 0011 0025 0000 0000 0000 0000 0000
0000 0000 0000 0000 0000 0017 0011 0011 0011 0011 0011 0011 0011 0011 0011 0011 0011 0011 0011 0011 0011 0011 0011 0011 0011 0011 0025 0000 0109 0000 0000 0000
0000 0000 0000 0000 0000 0017 0011 0011 0011 0011 0011 0011 0011 0011 0011 0011 0011 0011 0011 0011 0011 0011 0011 0011 0011 0011 0025 0000 0000 0000 0000 0000
0000 0000 0000 0000 0000 0017 0011 0011 0011 0011 0011 0011 0011 0011 0011 0011 0011 0011 0011 0011 0011 0011 0011 0011 0011 0011 0025 0000 0000 0000 0000 0000
0000 0000 0000 0000 0000 0017 0011 0011 0011 0011 0011 0011 0011 0011 0011 0011 0011 0011 0011 0137 0137 0137 0137 0137 0137 0137 0137 0000 0000 0000 0000 0000
0000 0000 0000 0000 0000 0017 0011 0011 0011 0011 0011 0011 0011 0011 0011 0011 0011 0011 0011 0011 0011 0011 0011 0011 0011 0011 0025 0000 0000 0000 0000 0000
0000 0000 0000 0000 0000 0017 0011 0011 0011 0011 0011 0011 0011 0011 0011 0011 0011 0011 0011 0011 0011 0011 0011 0011 0011 0011 0025 0000 0000 0000 0000 0000
0000 0000 0000 0000 0000 0017 0011 0011 0011 0011 0011 0011 0011 0011 0011 0011 0137 0011 0011 0011 0011 0011 0011 0011 0011 0011 0025 0000 0000 0000 0000 0000
0000 0000 0000 0000 0000 0017 0011 0011 0011 0011 0011 0011 0011 0011 0011 0011 0011 0011 0011 0011 0011 0011 0011 0011 0011 0011 0025 0000 0000 0000 0000 0000
0000 0000 0000 0000 0000 0017 0011 0011 0011 0011 0011 0011 0011 0011 0011 0011 0011 0011 0011 0011 0011 0011 0011 0011 0011 0011 0025 0000 0000 0000 0000 0000
0000 0000 0000 0000 0000 0017 0011 0011 0011 0011 0011 0011 0137 0011 0011 0011 0011 0011 0011 0011 0011 0011 0011 0011 0011 0011 0025 0000 0000 0000 0000 0000
0000 0000 0000 0000 0000 0017 0011 0011 0011 0011 0011 0011 0011 0011 0011 0011 0011 0011 0011 0011 0011 0011 0011 0011 0011 0011 0025 0000 0000 0000 0000 0000
0000 0000 0000 0000 0000 0017 0011 0011 0011 0011 0011 0011 0011 0011 0011 0011 0011 0011 0011 0011 0011 0011 0011 0011 0011 0011 0025 0000 0000 0000 0000 0000
0000 0000 0000 0000 0000 0017 0137 0137 0011 0011 0011 0011 0011 0011 0011 0011 0011 0011 0011 0011 0011 0011 0011 0011 0011 0011 0025 0000 0000 0000 0000 0000
0000 0000 0000 0000 0000 0017 0011 0011 0011 0011 0011 0011 0011 0011 0011 0011 0011 0011 0011 0011 0011 0011 0011 0011 0011 0011 0025 0000 0000 0000 0000 0000
0000 0000 0000 0000 0000 0017 0011 0011 0011 0011 0011 0011 0011 0011 0011 0011 0011 0011 0011 0011 0011 0011 0011 0011 0011 0011 0025 0000 0000 0000 0000 0000
0000 0000 0000 0000 0000 0017 0011 0011 0011 0011 0011 0011 0011 0011 0011 0011 0011 0011 0011 0011 0011 0011 0011 0011 0011 0011 0025 0000 0000 0000 0000 0000
0000 0000 0000 0000 0000 0017 0011 0011 0011 0011 0137 0137 0011 0011 0011 0011 0011 0011 0011 0011 0011 0011 0011 0011 0011 0011 0025 0000 0000 0000 0000 0000
0000 0000 0000 0000 0000 0017 0011 0011 0011 0011 0011 0011 0011 0011 0011 0011 0011 0011 0011 0011 0011 0011 0011 0011 0011 0011 0025 0000 0000 0000 0000 0000
0000 0000 0000 0000 0000 0017 0011 0011 0011 0011 0011 0011 0011 0011 0011 0011 0011 0011 0011 0011 0011 0011 0011 0011 0011 0011 0025 0000 0000 0000 0000 0000
0000 0000 0000 0000 0000 0017 0011 0011 0011 0011 0011 0011 0011 0011 0011 0011 0011 0011 0137 0137 0011 0011 0011 0011 0011 0011 0025 0000 0000 0000 0000 0000
0000 0000 0000 0000 0000 0017 0011 0011 0011 0011 0011 0011 0011 0011 0011 0011 0011 0011 0011 0011 0011 0011 0011 0011 0011 0011 0025 0000 0000 0000 0000 0000
0000 0000 0000 0000 0000 0017 0011 0011 0011 0011 0011 0011 0011 0011 0011 0011 0011 0011 0011 0011 0011 0011 0011 0011 0011 0011 0025 0000 0000 0000 0000 0000
0000 0000 0000 0000 0000 0017 0011 0011 0011 0011 0011 0011 0011 0011 0011 0011 0011 0011 0011 0011 0011 0011 0011 0011 0011 0011 0025 0000 0000 0000 0000 0000
0000 0000 0000 0000 0000 0017 0011 0011 0011 0011 0011 0137 0137 0011 0011 0011 0011 0011 0011 0011 0011 0011 0011 0011 0011 0011 0025 0000 0000 0000 0000 0000
0000 0000 0000 0000 0000 0017 0011 0011 0011 0011 0011 0011 0011 0011 0011 0011 0011 0011 0011 0011 0011 0011 0011 0011 0011 0011 0025 0000 0000 0000 0000 0000
0000 0000 0000 0000 0000 0017 1002 0011 0011 0011 0011 0011 0011 0011 0011 0011 0011 0011 0011 0011 0011 0011 0011 0011 1002 0011 0025 0000 0000 0000 0000 0000
0000 0000 0000 0000 0000 0017 0011 0011 0011 0011 0011 0011 0011 0011 0011 0011 0011 0011 0011 0011 0011 0011 0011 0011 0011 0011 0025 0000 0000 0000 0000 0000
0000 0000 0000 0000 0000 0017 0011 0011 0011 0011 0011 0011 0011 0011 0011 0011 0011 0011 0137 0137 0011 0011 0011 0011 0011 0011 0025 0000 0000 0000 0000 0000
0000 0000 0000 0000 0000 0017 0011 0011 0011 0011 0011 0011 0011 0011 0011 0011 0011 0011 0011 0011 0011 0011 0011 0011 0011 0011 0025 0000 0000 0000 0000 0000
0000 0000 0000 0000 0000 0017 0011 0011 0011 0011 0011 0011 0011 0011 0011 0011 0011 0011 0011 0011 0011 0011 0011 0011 0011 0011 0025 0000 0000 0000 0000 0000
0000 0000 0000 0000 0000 0017 0011 0011 0011 0011 0011 0011 0011 0011 0011 1009 0011 0011 0011 0011 0011 0011 0011 0011 0011 0011 0025 0000 0000 0000 0000 0000
0000 0000 0000 0000 0000 0017 0011 0011 0011 0011 0011 0137 0011 0011 0011 0011 0011 0011 0011 0011 0011 0011 0011 0011 0011 0011 0025 0000 0000 0000 0000 0000
0000 0000 0000 0000 0000 0017 0011 0011 0011 0011 0137 0011 0011 0011 0011 0011 0011 0011 0011 0011 0011 0011 0011 0011 0011 0011 0025 0000 0000 0000 0000 0000
0000 0000 0000 0000 0000 0017 0011 0011 0011 0011 0011 0011 0011 0011 0011 0011 0011 0011 0011 0011 0011 0011 0011 0011 0011 0011 0025 0000 0000 0000 0000 0000
0000 0000 0000 0000 0000 0017 0011 0011 0011 0011 0011 0011 0011 0011 0011 0011 0011 0011 0011 0011 0011 0011 0011 0011 0011 0011 0025 0000 0000 0000 0000 0000
0000 0000 0000 0000 0000 0017 0011 0011 0011 0011 0011 0011 0011 0011 0011 0011 0011 0011 0011 0011 0011 0011 0011 0011 0011 0011 0025 0000 0000 0000 0000 0000
0000 0000 0000 0000 0000 0017 0137 0011 0011 0011 0011 0011 0011 0011 0011 0011 0011 0011 0011 0011 0011 0011 0011 0011 0011 0011 0025 0000 0000 0000 0000 0000
0000 0000 0000 0000 0000 0017 0011 0011 0011 0011 0011 0011 0011 0011 0011 0011 0011 0011 0011 0011 0011 0011 0011 0011 0011 0011 0025 0000 0000 0000 0000 0000
0000 0000 0000 0000 0000 0017 0011 0011 0011 0011 0011 0011 0011 0011 0011 0011 0011 0011 0011 0011 0011 0011 0011 0011 0011 0011 0025 0000 0000 0000 0000 0000
0000 0000 0000 0000 0000 0017 0011 0011 0011 0011 0011 0011 0011 0011 0011 0011 0011 0011 0011 0011 0011 0011 0011 0011 0011 0011 0025 0000 0000 0000 0000 0000
0000 0000 0000 0000 0000 0017 0011 0011 0011 0011 0011 0011 0011 0011 0011 0011 0011 0011 0011 0011 0011 0011 0011 0011 0011 0011 0025 0000 0000 0000 0000 0000
0000 0109 0109 0000 0000 0017 0011 0011 0011 0011 0011 0011 0011 0011 0011 0011 0011 0011 0011 0011 0011 0011 0011 0011 0011 0011 0025 0000 0000 0000 0000 0000
0000 0000 0000 0000 0000 0017 0011 0011 0011 0011 0011 0011 0011 0011 0011 0011 0011 0011 0011 0011 0011 0011 0011 0011 0011 0011 0025 0000 0000 0000 0000 0000
0000 0000 0000 0000 0000 0017 0011 0011 0011 0011 0011 0011 0011 0011 0011 0011 0011 0011 0011 0011 0011 0011 0011 0011 0011 0011 0025 0000 0000 0000 0000 0000
0000 0000 0000 0000 0000 0017 0011 1004 0011 0011 0011 0011 0011 1004 0011 0011 0011 0011 0011 0011 0011 0011 0011 0011 0011 0011 0025 0000 0000 0000 0000 0000
0000 0000 0000 0000 0114 0114 0114 0114 0114 0011 0011 0011 0114 0114 0114 0114 0011 0011 0011 0011 0011 0011 0011 0011 0011 0011 0025 0000 0000 0000 0000 0000
0000 0000 0000 0000 0112 0112 0112 0112 0112 0011 0011 0011 0112 0112 0112 0112 0011 0011 0011 0011 0011 0011 0011 0011 0011 0011 0025 0000 0000 0000 0000 0000
0000 0000 0000 0000 0000 0017 0011 0011 0011 0011 0011 0011 0011 0011 0011 0011 0011 0011 0011 0011 0011 0011 0011 0011 0011 0011 0025 0000 0000 0000 0000 0000
0000 0000 0000 0000 0000 0017 0011 0011 0011 0011 0011 0011 0011 0011 0011 0011 0011 0011 0011 0011 0011 0011 0011 0011 0011 0011 0025 0000 0000 0000 0000 0000
0000 0000 0000 0000 0000 0017 0011 0011 0011 0011 0011 0011 0011 0011 0011 0011 0011 0011 0109 0109 0011 0011 0011 0011 0011 0011 0025 0000 0000 0000 0000 0000
0000 0000 0000 0000 0000 0017 0011 0011 0011 0011 0011 0011 0011 0011 0011 0011 0011 0011 0011 0011 0011 0011 0011 0011 0011 0011 0025 0000 0000 0000 0000 0000
0000 0000 0000 0000 0000 0017 0011 0011 0011 0011 0011 0011 0011 0011 0011 0011 0011 0011 0011 0011 0011 0011 0011 0011 0011 0011 0025 0000 0000 0000 0000 0000
0000 0000 0000 0000 0000 0017 0011 0011 0011 0011 0011 0011 0011 0011 0011 0011 0011 0011 0011 0011 0011 0011 0011 0011 0011 0011 0025 0000 0000 0000 0000 0000
0000 0000 0000 0000 0000 0017 0011 0011 0011 0011 0011 0011 0011 0011 0011 0011 0011 0011 0011 0011 0011 0011 0011 0011 0011 0011 0137 0000 0000 0000 0000 0000
0000 0000 0000 0000 0000 0017 0011 0011 0011 0011 0011 0011 0011 0011 0011 0011 0011 0011 1010 0011 0011 0011 0011 0011 0011 0011 0025 0000 0000 0000 0000 0000
0000 0000 0000 0000 0000 0017 0011 0011 0011 0011 0011 0011 0011 0011 0011 0011 0011 0011 0011 0011 0011 0011 0011 0011 0011 0011 0025 0000 0000 0000 0000 0000
0000 0000 0000 0000 0000 0017 0011 0011 0011 0011 0011 0011 0011 0011 0011 0011 0011 0011 0011 0011 0011 0011 0011 0011 0011 0011 0025 0000 0000 0000 0000 0000
0000 0000 0000 0000 0000 0017 0011 0011 0011 0011 0011 0011 0011 0011 0011 0137 0137 0011 0011 0011 0011 0137 0137 0137 0011 0011 0025 0000 0000 0000 0000 0000
0000 0000 0000 0000 0000 0017 0011 0011 0011 0011 0011 0011 0011 0137 0137 0011 0011 0011 0011 0011 0011 0011 0011 0011 0011 0011 0025 0000 0000 0000 0000 0000
0000 0000 0000 0000 0000 0017 0011 0011 0011 0011 0011 0011 0011 0011 0011 0011 0011 0011 0011 0011 0011 0011 0011 0011 0011 0011 0025 0000 0000 0000 0000 0000
0000 0000 0000 0000 0000 0017 0011 0011 0011 0011 0011 0011 0011 0011 0011 0011 0011 0011 0011 0011 0011 0011 0011 0011 0011 0011 0025 0000 0000 0000 0000 0000
0000 0000 0000 0000 0000 0137 0011 0011 0011 0011 0011 0011 0011 0011 0011 0011 0011 0011 0011 0011 0011 0011 0011 0011 0011 0011 0025 0000 0000 0000 0000 0000
0000 0000 0000 0000 0000 0017 0011 0011 0011 0011 0011 0011 0011 0011 0011 0011 0011 0011 0011 0011 0011 0011 0011 0011 0011 0011 0025 0000 0000 0000 0000 0000
0000 0000 0000 0000 0000 0017 0011 0011 0011 0011 0011 0011 0011 0011 0011 0011 0011 0011 0109 0109 0011 0011 0011 0011 0011 0011 0025 0000 0000 0000 0000 0000
0000 0000 0000 0000 0000 0017 0011 0011 0011 0011 0011 0011 0011 0011 0011 0011 0011 0011 0011 0011 0011 0011 0011 0011 0011 0011 0025 0000 0000 0000 0000 0000
0000 0000 0000 0000 0000 0017 0011 0011 0011 0011 0011 0011 0011 0011 0011 0011 0011 0011 0011 0011 0011 0011 0011 0011 0011 0011 0025 0000 0000 0000 0000 0000
0000 0000 0000 0000 0000 0017 0011 0011 0011 0137 0137 0011 0011 0011 0011 0011 0011 0011 0011 0011 0011 0011 0011 0011 0011 0011 0025 0000 0000 0000 0000 0000
0000 0000 0000 0000 0000 0017 0011 0011 0011 0011 0011 0011 0011 0011 0011 0011 0011 0011 0011 0011 0011 0011 0011 0011 0011 0011 0025 0000 0000 0000 0000 0000
0000 0000 0000 0000 0000 0017 0011 0011 0011 0011 0011 0011 0011 0011 0011 0011 0011 0011 0011 0011 0011 0011 0011 0011 0011 0011 0025 0000 0000 0000 0000 0000
0000 0000 0000 0000 0000 0017 0011 0011 0011 0011 0011 0011 0011 0011 0011 0011 0011 0011 0011 0011 0011 0011 0011 0011 0011 0011 0025 0000 0000 0000 0000 0000
0000 0000 0000 0000 0000 0017 0011 0011 0011 0011 0011 0011 0011 0011 0011 0011 0011 0011 0011 0011 0011 0011 0011 0011 0011 0011 0025 0000 0000 0000 0000 0000
0000 0000 0000 0000 0000 0017 0011 0011 0011 0011 0011 0011 0011 0011 0011 0011 0011 0011 0137 0137 0011 0011 0011 0011 0011 0011 0025 0000 0000 0000 0000 0000
0000 0000 0000 0000 0000 0017 0011 0011 0011 0011 0011 0011 0011 0011 0011 0011 0011 0011 0011 0011 0011 0011 0011 0011 0011 0011 0025 0000 0000 0000 0000 0000
0000 0000 0000 0000 0000 0017 0011 0011 0011 0011 0011 0011 0011 0011 0011 0011 0011 0011 0011 0011 0011 0011 0011 0011 0011 0011 0025 0000 0000 0000 0000 0000
0000 0000 0000 0000 0000 0017 0011 0011 0011 0011 0011 0011 0011 0011 0011 0011 0011 0011 0011 0011 0011 0011 0011 0011 0011 0011 0025 0000 0000 0000 0000 0000
0000 0000 0000 0000 0000 0017 0011 0011 0011 0137 0137 0011 0011 0011 0011 0011 0011 0011 0011 0011 0011 0011 0011 0011 0011 0011 0025 0000 0000 0000 0000 0000
0000 0000 0000 0000 0000 0017 0011 0011 0011 0011 0011 0011 0011 0011 0011 0011 0011 0011 2000 0011 0011 0011 0011 0011 0011 0011 0025 0000 0000 0000 0000 0000
0000 0000 0000 0000 0000 0017 0011 0011 0011 0011 0011 0011 0011 0011 0011 0011 0011 0011 0011 0011 0011 0011 0011 0011 0011 0011 0025 0000 0000 0000 0000 0000
0000 0000 0000 0000 0000 0017 0011 0011 0011 0011 0011 0011 0011 0011 0011 0011 0011 0011 0011 0011 0011 0011 0011 0011 0011 0011 0025 0000 0000 0000 0000 0000
0000 0000 0000 0000 0000 0017 0011 0011 0011 0011 0011 0011 0011 0011 0011 0011 0011 0011 0011 0011 0011 0011 0011 0011 0011 0011 0025 0000 0000 0000 0000 0000
0000 0000 0000 0000 0114 0114 0114 0114 0114 0114 0114 0114 0114 0114 0114 0114 0114 0114 0114 0114 0114 0114 0114 0114 0114 0114 0114 0114 0000 0000 0000 0000
0000 0000 0000 0000 0112 0112 0112 0112 0112 0112 0112 0112 0112 0112 0112 0112 0112 0112 0112 0112 0112 0112 0112 0112 0112 0112 0112 0112 0000 0000 0000 0000
0000 0000 0000 0000 0000 0017 0011 0011 0011 0011 0011 0011 0011 0011 0011 0011 0011 0011 0011 0011 0011 0011 0011 0011 0011 0011 0025 0000 0000 0000 0000 0000
0000 0000 0000 0000 0000 0017 0011 0011 0011 0011 0011 0011 0011 0011 0011 0011 0011 0011 0011 0011 0011 0011 0011 0011 0011 0011 0025 0000 0000 0000 0000 0000
0000 0000 0000 0000 0000 0017 0011 0011 0011 0011 0011 0011 0011 0011 0011 0011 0011 0011 0011 0011 0011 0011 0011 0011 0011 0011 0025 0000 0000 0000 0000 0000
0000 0000 0000 0000 0000 0017 0011 0011 0011 0011 0011 0011 0011 0011 0011 0011 0011 0011 0011 0011 0011 0011 0011 0011 0011 0011 0025 0000 0000 0000 0000 0000
0000 0000 0000 0000 0000 0017 0011 0018 0019 0011 0011 0011 0011 0011 0011 0018 0019 0011 0011 0011 0011 0011 0011 0018 0019 0011 0025 0000 0000 0000 0000 0000
0000 0000 0000 0000 0000 0017 0011 0026 0027 0011 0011 0011 0011 0011 0011 0026 0027 0011 0011 0011 0011 0011 0011 0026 0027 0011 0025 0000 0000 0000 0000 0000
0000 0000 0000 0000 0000 0017 0011 0011 0011 0011 0011 0011 0011 0011 0011 0011 0011 0011 0011 0011 0011 0011 0011 0011 0011 0011 0025 0000 0000 0000 0000 0000