0000 0000 0000 0000 0000 0000 0000 0000 0000 0000 0000 0000 0000 0000 0000 0000 0000 0000 0000 0000 0000 0000 0000 0000 0000 0000
0000 0000 0000 0000 0000 0000 0000 0000 0000 0000 0000 0000 0000 0000 0000 0000 0000 0000 0000 0000 0000 0000 0000 0000 0000 0000
0000 0000 0000 0000 0000 0000 0000 0000 0000 0000 0000 0000 0000 0000 0000 0000 0000 0000 0000 0000 0000 0000 0000 0000 0000 0000
0000 0000 0000 0000 0000 0000 0000 0000 0000 0000 0000 0000 0000 0000 0000 0000 0000 0000 0000 0000 0000 0000 0000 0000 0000 0000
0000 0000 0000 0000 0000 0000 0000 0000 0000 0000 0000 0000 0000 0000 0000 0000 0000 0000 0000 0000 0000 0000 0000 0000 0000 0000
0000 0000 0000 0000 0000 0000 0000 0000 0000 0000 0000 0000 0000 0000 0000 0000 0000 0000 0000 0000 0000 0000 0000 0000 0000 0000
0000 0000 0000 0000 0000 0000 0000 0000 0000 0000 0000 0000 0000 0000 0000 0000 0000 0000 0000 0000 0000 0000 0000 0000 0000 0000
0000 0000 0000 0000 0000 0000 0000 0000 0000 0000 0000 0000 0000 0000 0000 0000 0000 0000 0000 0000 0000 0000 1004 0000 0000 0000
0000 0000 0000 0000 0000 0000 0000 0000 0000 0000 0000 0000 0000 0000 1004 0000 0000 0000 0000 0000 0105 0105 0105 0105 0105 0105
0000 0000 0000 0000 0000 0000 0000 0000 0000 0000 0000 0000 0000 0105 0105 0105 0105 0105 0105 0105 0104 0104 0104 0104 0104 0104
0000 0000 0000 0000 0105 0105 0105 0105 0105 0105 0105 0105 0105 0104 0104 0104 0104 0104 0104 0104 0104 0104 0104 0104 0104 0104
0105 0105 0105 0105 0104 0104 0104 0104 0104 0104 0104 0104 0104 0104 0106 0104 0104 0104 0104 0104 0104 0104 0104 0104 0104 0104
0104 0104 0104 0104 0104 0104 0104 0104 0104 0104 0104 0104 0104 0104 0104 0104 0104 0104 0104 0104 0104 0104 0104 0104 0104 0104

0000 0000 0000 0000 0000 0000 0000 0000 0000 0000 0000 0000 0000 0000 0000 0000 0000 0000 0000 0000 0000 0000 0000 0000 0000 0000
0000 0000 0000 0000 0000 0000 0000 0000 0000 0000 0000 0000 0000 0000 0000 0000 0000 0000 0000 0000 0000 0000 0000 0000 0000 0000
0000 0000 0000 0000 0000 0000 0000 0000 0000 0000 0000 0000 0000 0000 0000 0000 0000 0000 0000 0000 0000 0000 0000 0000 0000 0000
0000 0000 0000 0000 0000 0000 0000 0000 0000 0000 0000 0000 0000 0000 0000 0000 0000 0000 0000 0000 0000 0000 0000 0000 0000 0000
0000 0000 0000 0000 0000 0000 0000 0000 0000 0000 0000 0000 0000 0000 0000 0000 0000 0000 0000 0000 0000 0000 0000 0000 0000 0000
0000 0000 0000 0000 0000 0000 0000 0000 0000 0000 0000 0000 0000 0000 0000 0000 0000 0000 0000 0000 0000 0000 0000 0000 0000 0000
0000 0000 0000 0000 0000 0000 0000 0000 0000 0000 0000 0000 0000 0000 0000 0000 0000 0000 0000 0000 0000 0000 0000 0000 0000 0000
0000 0000 0000 0000 0000 0000 0107 0108 0000 0000 0000 0000 0000 0000 0000 0000 0000 0000 0000 0000 0000 0000 0000 0000 0000 0000
0105 0105 0105 0105 0105 0122 0115 0116 0000 0000 0000 0000 0105 0105 0105 0105 0105 0105 0000 0000 0000 0000 0105 0105 0105 0105
0104 0104 0121 0104 0104 0104 0123 0124 0000 0000 0000 0000 0104 0104 0104 0104 0104 0104 0000 0000 0000 0000 0104 0104 0104 0104
0104 0104 0104 0104 0104 0104 0104 0104 0000 0000 0000 0000 0104 0104 0104 0104 0104 0104 0000 0000 0000 0000 0104 0104 0104 0104
0104 0104 0104 0104 0104 0104 0104 0104 0105 0105 0105 0105 0104 0104 0104 0106 0104 0104 0000 0000 0000 0000 0104 0104 0104 0104
0104 0104 0104 0104 0104 0104 0104 0104 0104 0104 0104 0104 0104 0104 0104 0104 0104 0104 0000 0000 0000 0000 0104 0104 0104 0104

0000 0000 0000 0000 0000 0000 0000 0000 0000 0000 0000 0000 0000 0000 0000 0000 0000 0000 0000 0000 0000 0000 0000 0000 0000 0000
0000 0000 0000 0000 0000 0000 0000 0000 0000 0000 0000 0000 0000 0000 0000 0000 0000 0000 0000 0000 0000 0000 0000 0000 0000 0000
0000 0000 0000 0000 0000 0000 0000 0000 0000 0000 0000 0000 0000 0000 0000 0000 0000 0000 0000 0000 0000 0000 0000 0000 0000 0000
0000 0000 0000 0000 0000 0000 0000 0000 0000 0000 0000 0000 0000 0000 0000 0000 0000 0000 0000 0000 0000 0000 0000 0000 0000 0000
0000 0000 0000 0000 0000 0000 0000 0000 0000 0000 0000 0000 0000 0000 0000 0000 0000 0000 0000 0000 0000 0000 0000 0000 0000 0000
0000 0000 0000 0000 0000 0000 0000 0000 0000 0000 0000 0000 0000 0000 0000 0000 0000 0000 0000 0000 0000 0000 0000 0000 0000 0000
0000 0000 0000 0000 0000 0000 0000 0000 0000 0000 0000 0000 0000 0000 0000 0000 0000 0000 0000 0000 0000 0105 0105 0105 0105 0105
0000 0000 0000 0000 0000 0000 0000 0000 0000 0000 0000 0000 0000 0000 0000 0000 0000 0000 0000 0000 0109 0104 0104 0104 0104 0104
0105 0105 0105 0105 0105 0105 0000 0000 0000 0000 0000 0000 0000 0000 0000 0000 0000 0000 0000 0000 0109 0104 0104 0121 0104 0104
0104 0104 0104 0104 0104 0104 0105 0105 0000 0000 0000 0000 0000 0000 0000 0000 0000 0000 0000 0000 0109 0104 0104 0104 0104 0104
0104 0104 0104 0104 0104 0104 0104 0104 0105 0105 0000 0000 0000 0000 0000 0000 0000 0000 0000 0000 0110 0104 0104 0104 0104 0104
0104 0104 0104 0104 0104 0106 0104 0104 0104 0104 0105 0105 0105 0000 0000 0000 1004 0000 0000 0000 0109 0104 0104 0104 0104 0104
0104 0104 0104 0104 0104 0104 0104 0104 0104 0104 0104 0104 0104 0105 0105 0105 0105 0105 0105 0105 0105 0104 0104 0104 0104 0104

0000 0000 0000 0000 0000 0000 0000 0000 0000 0000 0000 0000 0000 0000 0000 0000 0000 0000 0000 0000 0000 0000 0000 0000 0000 0000
0000 0000 0000 0000 0000 0000 0000 0000 0000 0000 0000 0000 0000 0000 0000 0000 0000 0000 0000 0000 0000 0000 0000 0000 0000 0000
0000 0000 0000 0000 0000 0000 0000 0000 0000 0000 0000 0000 0000 0000 0000 0000 0000 0000 0000 0000 0000 0000 0000 0000 0000 0000
0000 0000 0000 0000 0000 0000 0000 0000 0000 0000 0000 0000 0000 0000 0000 0000 0000 0000 0000 0000 0000 0000 0000 0000 0000 0000
0000 0000 0000 0000 0000 0000 0000 0000 0000 0000 0000 0000 0000 0000 0000 0000 0000 0000 0000 0000 0000 0000 0000 0000 0000 0000
0000 0000 0000 0000 0000 0000 0000 0000 0000 0000 0000 0000 0000 0105 0105 0105 0105 0105 0000 0000 0000 0000 0000 0000 0000 0000
0105 0105 0105 0105 0105 0105 0000 0000 0000 0000 0000 0000 0000 0000 0000 0000 0000 0000 0000 0000 0000 0000 0000 0000 0000 0000
0104 0104 0104 0104 0104 0104 0105 0105 0000 0000 0000 0000 0000 0000 0000 0000 0000 0000 0000 0000 0000 0000 0000 0000 0000 0000
0104 0104 0104 0104 0104 0104 0104 0104 0105 0105 0043 0043 0043 0043 0043 0043 0043 0043 0043 0043 0000 0000 1004 0000 0105 0105
0104 0104 0104 0104 0104 0104 0106 0104 0104 0104 0142 0142 0142 0142 0142 0142 0142 0142 0142 0142 0105 0105 0105 0105 0104 0104
0104 0104 0104 0104 0104 0104 0104 0104 0104 0104 0142 0142 0142 0142 0142 0142 0142 0142 0142 0142 0104 0104 0104 0104 0104 0104
0104 0104 0104 0104 0104 0104 0104 0104 0104 0104 0104 0104 0104 0104 0104 0104 0104 0104 0104 0104 0104 0104 0104 0104 0104 0104
0104 0104 0104 0104 0104 0104 0104 0104 0104 0104 0104 0104 0104 0104 0104 0104 0104 0104 0104 0104 0104 0104 0104 0104 0104 0104

0000 0000 0000 0000 0000 0000 0000 0000 0000 0000 0000 0000 0000 0000 0000 0000 0000 0000 0000 0000 0000 0000 0000 0000 0000 0000
0000 0000 0000 0000 0000 0000 0000 0000 0000 0000 0000 0000 0000 0000 0000 0000 0000 0000 0000 0000 0000 0000 0000 0000 0000 0000
0000 0000 0000 0000 0000 0000 0000 0000 0000 0000 0000 0000 0000 0000 0000 0000 0000 0000 0000 0000 0000 0000 0000 0000 0000 0000
0000 0000 0000 0000 0000 0000 0000 0000 0000 0000 0000 0000 0000 0000 0000 0000 0000 0000 0000 0000 0000 0000 0000 0000 0000 0000
0000 0000 0000 0000 0000 0000 0000 0000 0000 0000 0000 0000 0000 0000 0000 0000 0000 0000 0000 0000 0000 0000 0000 0000 0000 0000
0000 0000 0000 0000 0000 0000 0000 0000 0000 0000 0000 0000 0000 0000 0000 0000 0000 0000 0000 0000 0000 0000 0000 0000 0000 0000
0000 0000 0000 0000 0000 0000 0000 0000 0000 0000 0000 0000 0000 0000 0000 0000 0000 0000 0000 0000 0000 0000 0000 0000 0000 0000
0000 0000 0000 0000 0000 0000 0000 0000 0000 0000 0000 0000 0000 0000 0000 0000 0000 0000 0000 0000 0000 0000 0000 0000 0000 0000
0105 0105 0105 0105 0105 0105 0105 0105 0105 0105 0105 0105 0000 0000 0000 0000 0000 0000 0000 0000 0000 0000 0000 0000 0000 0000
0104 0104 0104 0104 0104 0104 0104 0104 0104 0104 0104 0104 0105 0105 0105 0105 0105 0000 0000 0000 0000 0000 0000 0000 0000 0000
0104 0104 0104 0104 0104 0104 0104 0104 0104 0104 0104 0104 0104 0104 0104 0104 0104 0105 0105 0105 0105 0105 0000 0000 0000 0000
0104 0104 0104 0104 0104 0104 0104 0104 0104 0104 0104 0104 0104 0104 0104 0104 0104 0104 0104 0104 0104 0104 0105 0105 0105 0105
0104 0104 0104 0104 0104 0104 0104 0104 0104 0104 0104 0104 0104 0104 0104 0104 0104 0104 0104 0104 0104 0104 0104 0104 0104 0104

0000 0000 0000 0000 0000 0000 0000 0000 0000 0000 0000 0000 0000 0000 0000 0000 0000 0000 0000 0000 0000 0000 0000 0000 0000 0000
0000 0000 0000 0000 0000 0000 0000 0000 0000 0000 0000 0000 0000 0000 0000 0000 0000 0000 0000 0000 0000 0000 0000 0000 0105 0105
0000 0000 0000 0000 0000 0000 0000 0000 0000 0000 0000 0000 0000 0000 0000 0105 0105 0000 0000 0000 0000 0000 0000 0000 0000 0000
0000 0000 0000 0000 0000 0000 0000 0000 0000 0000 0000 0000 0000 0000 0000 0000 0000 0000 0000 0000 0000 0000 0000 0000 0000 0000
0000 0000 0000 0000 0000 0000 0000 0000 0000 0000 0000 0000 0000 0000 0000 0000 0000 0000 0000 0000 0000 0000 0000 0000 0000 0000
0000 0000 0000 0000 0000 0000 0000 0000 0105 0105 0105 0105 0000 0000 0000 0000 0000 0000 0000 0000 0000 0000 0000 0000 0000 0000
0000 0000 0000 0000 0000 0000 0000 0000 0000 0000 0000 0000 0000 0000 0000 0000 0000 0000 0000 0000 0000 0000 0000 0000 0000 0000
0000 0000 0000 0000 0000 0000 0000 0000 0000 0000 0000 0000 0000 0000 0000 0000 0000 0000 0000 0000 0000 0000 0000 0000 0000 0000
0000 0000 0105 0105 0105 0000 0000 0000 0000 0000 0000 0000 0000 0000 0000 0000 0000 0000 0000 0000 0000 0000 0000 0000 0000 0000
0000 0000 0104 0104 0104 0000 0000 0000 0000 0000 0000 0000 0000 0000 0000 0000 0000 0000 0000 0000 0000 0000 0000 0000 0000 0000
0000 0000 0104 0121 0104 0000 0000 0000 0000 0000 0000 0000 0000 0000 0000 0000 0000 0000 0000 0000 0000 0000 0000 0000 0000 0000
0105 0105 0104 0104 0104 0105 0105 0105 0105 0105 0105 0105 0105 0105 0105 0105 0105 0105 0105 0105 0105 0105 0105 0105 0105 0105
0104 0104 0104 0104 0104 0104 0104 0104 0104 0106 0104 0104 0104 0104 0104 0104 0104 0104 0104 0104 0104 0104 0104 0104 0104 0104

0000 0000 0000 0000 0000 0000 0000 0000 0000 0000 0000 0000 0000 0000 0000 0000 0000 0000 0000 0000 0000 0000 0000 0000 0000 0000
0105 0105 0000 0000 0000 0000 0000 0000 0000 0000 0000 0000 0000 0000 0000 0000 0000 0000 0000 0000 0000 0000 0000 0000 0000 0000
0000 0000 0000 0000 0000 0000 0000 0000 0000 0000 0000 0000 0000 0000 0000 0000 0000 0000 0000 0000 0000 0000 1004 0000 0000 0000
0000 0000 0000 0000 0000 0000 0000 0000 0000 0000 0000 0000 0000 0000 0000 0000 0000 0000 0000 0000 0000 0000 0105 0105 0105 0105
0000 0000 0000 0000 0000 0000 0000 0000 0000 0000 0000 0000 0000 0000 0000 0000 0000 0000 0000 0000 0000 0000 0000 0000 0000 0000
0000 0000 0000 0000 0000 0105 0105 0105 0105 0105 0000 0000 0000 0000 0000 0105 0105 0105 0000 0000 0000 0000 0000 0000 0000 0000
0000 0000 0000 0000 0000 0000 0000 0000 0000 0000 0000 0000 0000 0000 0000 0000 0000 0000 0000 0000 0000 0000 0000 0000 0000 0000
0000 0000 0000 0000 0000 0000 0000 0000 0000 0000 0000 0000 0000 0000 0000 0000 0000 0000 0000 0000 0000 0000 0000 0000 0000 0000
0000 0000 0000 0000 0000 0000 0000 0000 0000 0000 0000 0000 0000 0000 0000 0000 0000 0000 0000 0000 0000 0000 0000 0000 0000 0000
0000 0000 0000 0000 0000 0000 0000 0000 0000 0000 0000 0000 0000 0000 0000 0000 0000 0000 0000 0000 0000 0000 0000 0000 0000 0000
0000 0000 0000 0000 0000 0000 0000 0000 0000 0000 0000 0000 0000 0000 0000 0000 0000 0000 0000 0000 0000 0000 0000 0000 0000 0000
0105 0105 0105 0105 0105 0105 0105 0105 0105 0105 0105 0105 0105 0105 0105 0105 0105 0105 0105 0105 0105 0105 0105 0105 0105 0105
0104 0104 0104 0104 0104 0104 0104 0104 0104 0104 0104 0104 0104 0104 0104 0106 0104 0104 0104 0104 0104 0104 0104 0104 0104 0104

0000 0000 0000 0000 0000 0000 0000 0000 0000 0000 0000 0000 0000 0000 0000 0000 0000 0000 0000 0000 0000 0000 0000 0000 0000 0000
0000 0000 0000 0000 0000 0000 0000 0000 0000 0000 0000 0000 0000 0000 0000 0000 0000 0000 0043 0000 0000 0000 0000 0000 0000 0000
0000 0000 0000 0000 0000 0000 0000 0000 0000 0000 0000 0000 0000 0000 0000 0000 0000 0000 0142 0000 0000 0000 0043 0000 0000 0000
0105 0000 0000 0000 0000 0000 0000 0000 0000 0000 0000 0000 0000 0000 0000 0000 0105 0105 0105 0105 0105 0000 0142 0000 0000 0000
0000 0000 0000 0000 0000 0000 0000 0000 0000 0000 0000 0000 0000 0000 0105 0105 0104 0104 0104 0104 0104 0000 0142 0000 0000 0000
0000 0000 0000 0000 0000 0000 0105 0105 0105 0000 0000 0000 0000 0000 0104 0104 0104 0104 0104 0104 0104 0105 0105 0105 0000 0000
0000 0000 0000 0000 0000 0000 0000 0000 0000 0000 0000 0000 0000 0000 0104 0104 0106 0104 0104 0104 0104 0104 0104 0104 0105 0105
0000 0000 0000 0000 0000 0000 0000 0000 0000 0000 0000 0000 0000 0000 0104 0104 0104 0104 0104 0104 0104 0104 0104 0104 0104 0104
0000 0000 0000 0000 0000 0000 0000 0000 0000 0000 0000 0000 0000 0000 0104 0104 0104 0104 0104 0104 0104 0104 0104 0104 0104 0104
0000 0000 0000 0000 0000 0000 0000 0000 0000 0000 0000 0000 0000 0000 0104 0104 0104 0104 0104 0104 0104 0104 0104 0104 0104 0104
0000 0000 0000 0000 0000 0000 0000 0000 0000 0000 0000 0000 0000 0000 0104 0104 0104 0104 0104 0104 0104 0104 0104 0104 0104 0104
0105 0105 0105 0105 0105 0105 0105 0105 0105 0105 0105 0105 0105 0105 0104 0104 0104 0104 0104 0104 0104 0104 0104 0104 0104 0104
0104 0104 0104 0104 0104 0104 0104 0104 0104 0104 0104 0104 0104 0104 0104 0104 0104 0104 0104 0104 0104 0104 0104 0104 0104 0104

0000 0000 0000 0000 0000 0000 0000 0000 0000 0000 0000 0000 0000 0000 0000 0000 0000 0000 0000 0000 0000 0000 0000 0000 0000 0000
0000 0000 0000 0000 0000 0000 0000 0000 0000 0000 0000 0000 0000 0000 0000 0000 0000 0000 0000 0000 0000 0000 0000 0000 0000 0000
0000 0000 0000 0000 0000 0000 0000 0000 0000 0000 0000 0000 0000 0000 0000 0000 0000 0000 0000 0000 0000 0000 0000 0000 0000 0000
0000 0000 0000 0000 0000 0000 0000 0000 0000 0000 0000 0000 0000 0000 0000 0000 0000 0000 0000 0105 0105 0000 0000 0000 0000 0000
0000 0000 0000 0000 0000 0105 0105 0000 0000 0000 0000 0000 0000 0000 0000 0000 0000 0000 0000 0000 0000 0000 0000 0000 0000 0000
0000 0000 0000 0000 0000 0000 0000 0000 0000 0000 0000 0000 1004 0000 0000 0000 0000 0000 0000 0000 0000 0000 0000 0000 0000 0000
0000 0000 0000 0000 0000 0000 0000 0000 0000 0000 0000 0105 0105 0105 0105 0105 0000 0000 0000 0000 0000 0000 0000 0000 0000 0105
0105 0105 0000 0000 0000 0000 0000 0000 0000 0000 0000 0104 0104 0104 0104 0104 0000 0000 0000 0000 0000 0000 0000 0000 0000 0104
0104 0104 0043 0043 0043 0043 0043 0043 0043 0043 0043 0104 0104 0104 0104 0104 0043 0043 0043 0043 0043 0043 0043 0043 0043 0104
0104 0104 0142 0142 0142 0142 0142 0142 0142 0142 0142 0104 0104 0106 0104 0104 0142 0142 0142 0142 0142 0142 0142 0142 0142 0104
0104 0104 0142 0142 0142 0142 0142 0142 0142 0142 0142 0104 0104 0104 0104 0104 0142 0142 0142 0142 0142 0142 0142 0142 0142 0104
0104 0104 0104 0104 0104 0104 0104 0104 0104 0104 0104 0104 0104 0104 0104 0104 0104 0104 0104 0104 0104 0104 0104 0104 0104 0104
0104 0104 0104 0104 0104 0104 0104 0104 0104 0104 0104 0104 0104 0104 0104 0104 0104 0104 0104 0104 0104 0104 0104 0104 0104 0104

0000 0000 0000 0000 0000 0000 0000 0000 0000 0000 0000 0000 0000 0000 0000 0000 0000 0000 0000 0000 0000 0000 0000 0000 0000 0000
0000 0000 0000 0000 0000 0000 0000 0000 0000 0000 0000 0000 0000 0000 0000 0000 0000 0000 0000 0000 0000 0000 0000 0000 0000 0000
0000 0000 0000 0000 0000 0000 0000 0000 0000 0000 0000 0000 0000 0000 0000 0000 0000 0000 0000 0000 0000 0000 0000 0000 0000 0000
0000 0000 0000 0000 0000 0000 0000 0000 0105 0105 0105 0000 0000 0000 0105 0105 0105 0000 0000 0000 0000 0000 0000 0000 0000 0000
0000 0000 0000 0000 0000 0000 0000 0000 0000 0000 0000 0000 0000 0000 0104 0104 0104 0000 0000 0000 0000 0000 0000 0000 0000 0000
0000 1004 0000 0000 0000 0000 0000 0000 0000 0000 0000 0000 0000 0000 0104 0104 0104 0000 0000 0000 0000 0000 0000 0000 0000 0000
0105 0105 0105 0105 0105 0000 0000 0000 0000 0000 0000 0000 0000 0000 0104 0104 0104 0000 0000 0000 0105 0105 0105 0000 0000 0000
0104 0104 0104 0104 0104 0000 0000 0000 0000 0000 0000 0000 0000 0000 0104 0104 0104 0000 0000 0000 0000 0000 0000 0000 0000 0000
0104 0104 0104 0104 0104 0043 0043 0043 0043 0043 0043 0043 0043 0043 0104 0104 0104 0043 0043 0043 0043 0043 0043 0043 0043 0043
0104 0104 0104 0104 0104 0142 0142 0142 0142 0142 0142 0142 0142 0142 0104 0104 0104 0142 0142 0142 0142 0142 0142 0142 0142 0142
0104 0104 0104 0104 0104 0142 0142 0142 0142 0142 0142 0142 0142 0142 0104 0104 0104 0142 0142 0142 0142 0142 0142 0142 0142 0142
0104 0104 0104 0104 0104 0104 0104 0104 0104 0104 0104 0104 0104 0104 0104 0104 0104 0104 0104 0104 0104 0104 0104 0104 0104 0104
0104 0104 0104 0104 0104 0104 0104 0104 0104 0104 0104 0104 0104 0104 0104 0104 0104 0104 0104 0104 0104 0104 0104 0104 0104 0104

0000 0000 0000 0000 0000 0000 0000 0000 0000 0000 0000 0000 0000 0000 0000 0000 0000 0000 0000 0000 2000 0000 0000 0000 0000 0000
0000 0000 0000 0000 0000 0000 0000 0000 0000 0000 0000 0000 0000 0000 0000 0000 0000 0000 0000 0000 0000 0000 0000 0000 0000 0000
0000 0000 0000 0000 0000 0000 0000 0000 0000 0000 0000 0000 0000 0000 0000 0000 0000 0000 0000 0000 0000 0000 0000 0000 0000 0000
0000 0000 0000 0000 0000 0000 0000 0000 0000 0000 0000 0000 0000 0000 0000 0000 0000 0000 0000 0000 0000 0000 0000 0000 0000 0000
0000 0000 0000 0000 0000 0000 0000 0000 0000 0000 0000 0000 0000 0000 0000 0000 0105 0105 0105 0105 0105 0105 0105 0105 0105 0105
0000 0000 0000 0000 0000 0000 0000 0000 0000 0000 0000 0000 0105 0105 0105 0105 0104 0104 0104 0104 0104 0104 0104 0104 0104 0104
0000 0000 0000 0105 0105 0105 0105 0105 0105 0105 0105 0105 0104 0104 0104 0104 0104 0104 0104 0104 0104 0104 0104 0104 0104 0104
0000 0000 0000 0104 0104 0104 0104 0104 0104 0104 0104 0104 0104 0104 0104 0104 0104 0104 0104 0104 0104 0104 0104 0104 0104 0104
0043 0043 0043 0104 0104 0104 0104 0104 0104 0104 0104 0104 0106 0104 0104 0104 0104 0104 0104 0104 0104 0104 0104 0104 0104 0104
0142 0142 0142 0104 0104 0104 0104 0104 0104 0104 0104 0104 0104 0104 0104 0104 0104 0104 0104 0104 0104 0104 0104 0104 0104 0104
0142 0142 0142 0104 0104 0104 0104 0104 0104 0104 0104 0104 0104 0104 0104 0104 0104 0104 0104 0104 0104 0104 0104 0104 0104 0104
0104 0104 0104 0104 0104 0104 0104 0104 0104 0104 0104 0104 0104 0104 0104 0104 0104 0104 0104 0104 0104 0104 0104 0104 0104 0104
0104 0104 0104 0104 0104 0104 0104 0104 0104 0104 0104 0104 0104 0104 0104 0104 0104 0104 0104 0104 0104 0104 0104 0104 0104 0104