0000 0000 0000 0000 0000 0000 0000 0000 0000 0000 0000 0000 0000 0000 0000 0104 0104 0104 0104 0104 0000 0000 0000 0000 0000 0000 0000 0000 0000 0000 0000
0000 0000 0000 0000 0000 0000 0000 0000 0000 0000 0000 0105 0000 0000 0000 0000 0000 0000 0000 0104 0000 0000 0000 0000 0000 0000 0000 0000 0000 0000 0000
0000 0000 0000 0000 0000 0000 0000 0000 0000 1002 0000 0104 0000 0000 0000 0000 0000 1001 0000 0000 0000 0000 0000 0000 0000 0000 0000 0000 0000 0000 0000
0000 0000 0000 0000 0000 0000 0000 0000 0000 0000 0000 0106 0000 0000 0000 0000 0000 0000 0000 0000 0000 0000 0000 0000 0000 0000 0000 0000 0000 0000 0000
0000 0000 0000 0000 0105 0000 0000 0000 0000 0000 0000 0000 0000 0000 0000 0000 0000 0000 0000 0000 0000 0105 0000 0000 1003 0000 0000 0000 0000 0000 0000
0000 0000 0000 0105 0104 0000 0105 0105 0000 0000 0000 0000 0000 0000 0000 0000 0000 0000 0000 0000 0105 0106 0000 0000 0000 0000 0000 0000 0000 0000 0000
0105 0105 0105 0104 0106 0105 0104 0104 0105 0105 0105 0105 0105 0105 0105 0000 0105 0000 0105 0000 0104 0104 0000 0105 0105 0105 0000 0105 0105 0105 0105
0104 0104 0104 0104 0104 0104 0104 0104 0104 0104 0104 0104 0104 0104 0104 0000 0104 0000 0104 0000 0104 0104 0000 0104 0104 0104 0000 0104 0104 0104 0104